**************************************************************
**                                                          **
**                                                          **
**                                                          **
**                                                          **
**                                                          **
**                                                          **
**                                                          **
**                                                          **
**                                                          **
**                                                          **
**                                                          **
**                                                          **
**                                                          **
**                                                          **
**                                                          **
**                                                          **
**                                                          **
**************************************************************